Contexte Gauche	Mot Cible	Contexte Droit
+ 1.1 Preventive 	lockdown	
+ 1.2 Emergency 	lockdown	
* 3 Newsworthy 	lockdowns	
	lockdowns	. For the practice of isolating prisoners, see Solitary
A 	lockdown	 (/ËlÉkËdaÊn/ ^â) is a restriction policy for people,
A 	lockdown	 can also be used to protect people inside a facility or, for
[250px-Zone_wise_	lockdown	_in_new_Bhopal_2.jpg] Street barricades that
Preventive 	lockdown	
A preventive 	lockdown	 is a preemptive action plan implemented to
Preventive lockdowns are preemptive 	lockdowns	 to mitigate risk. Most
organisations plan for the emergency 	lockdowns	 but fail to plan for
implement a more limited 	lockdown	 while teaching in school continues,
thus eliminating need for complete emergency 	lockdown	, disruption and
procedures to implement such 	lockdowns	 is that the situation might
Emergency 	lockdown	
Emergency 	lockdowns	 are implemented when there is imminent threat to
emergency 	lockdown	 procedures must be kept short and simple to make
can be easily taught with periodic 	lockdown	 drills instead of lengthy
Both preventative and emergency 	lockdowns	 can be adopted for similar
A 	lockdown	 was implemented in Mexico from April 30 to May 5, 2009 in
Main article: COVID-19 	lockdowns	
During the COVID-19 pandemic, the term 	lockdown	 was used for actions
	lockdown	 during the pandemic was implemented in Wuhan on January 23,
some form of 	lockdown	âmore than half the world's population.^[8]^[9] By
late April, around 300 million people were under 	lockdown	 in European
countries, while around 200 million people were under 	lockdown	 in Latin
population, were under some form of 	lockdown	 in the United States,^[11]
and 1.3 billion people have been under 	lockdown	 in India.^[12]
The 	lockdown	 in the Philippines started on 14 March 2020 and is one of
the longest and strictest 	lockdowns	 with varying levels of community
Similarly the 	lockdown	 in South Africa started on 27 March 2020^[15]
	lockdowns	 in the world with cigarettes and alcohol banned
Lockdown procedures vary by site and country. Generally, a 	lockdown	
staff must remain in their location from the time the 	lockdown	 is
attacks, 	lockdown	 procedures in schools have been changing. Some
In prisons, the term 	lockdown	 can be defined as a course of action to
"	lockdown	 period" in a corrections schedule.^[citation needed] However
a "full 	lockdown	" is used when all prisoners are locked in their cells
In manufacturing, the term 	lockdown	 event refers to a continuous
	lockdown	 event a multi-disciplinary team reviews the specific area's
	lockdown	 is lifted and production is resumed. Follow-up sampling is
conducted subsequently to ensure continuity of the 	lockdown	 results.
Newsworthy 	lockdowns	
In the wake of the September 11 attacks (2001), a three-day 	lockdown	 of
issued a 	lockdown	 order on one of the buildings on campus for six
contacted and the 	lockdown	 lasted for more than two hours. New
Team (ERT) was called, and the school was under 	lockdown	 until
In August 2019, the Indian government imposed a 	lockdown	 on Jammu and
by communications and media blackout, claiming that the 	lockdown	 was to
According to Merriam-Webster, the first known use of 	lockdown	 occurred
contains the first reference to 	lockdown	.
gunman prompted few calls for a 	lockdown	 of the Capitol."
Elsa Brenner: "Dr. Hornsby declared a 	lockdown	 in the city's
resulted in one '	lockdown	' in the past year. On Oct. 26, parents
say, a 	lockdown	 was declared at another school, Mandalay
By Frances X. Clines: "the Senate went into 	lockdown	 with
massive security 	lockdown	' at all Yonkers schools. ...All but
termed a '	lockdown	' drill in which students and teachers,
1. ^ "Capitalist 	lockdown	 is bad. Capitalist reopening is worse | Red
6. ^ Resnick, Brian (10 March 2020). "Italy and China used 	lockdowns	
"Wuhan 	lockdown	: A year of China's fight against the Covid
8. ^ "Coronavirus: Half of humanity now on 	lockdown	 as 90 countries
	lockdown	âhere's our constantly updated list of countries and
map shows which cities and states are under 	lockdown	". Business
12. ^ Nair S (29 March 2020). "For a billion Indians, 	lockdown	 has not
	lockdowns	". Deutsche Welle. Deutsche Welle. 20 July 2020. Retrieved
14. ^ "The Philippines' fierce 	lockdown	 drags on, despite uncertain
benefit from world's strictest 	lockdown	". The Times.
22. ^ "Police increase presence at UBC following 	lockdown	"
23. ^ "Threat prompts 	lockdown	 at UBC". The Globe and Mail. Retrieved
24. ^ "North York: Two charged after George S. Henry Academy 	lockdown	".
25. ^ "Teen arrested in connection with school 	lockdown	". Archived from
28. ^ Boston faces 	lockdown	 as police hunt for marathon bombing
29. ^ "Restrictions eased as Kashmir enters Day 22 of 	lockdown	". India
31. ^ Merriam-Webster definition of 	lockdown	
* The dictionary definition of 	lockdown	 at Wiktionary* 3 Table of pandemic 	lockdowns	
COVID-19 	lockdowns	
"The 	lockdowns	" redirects here. For the general topic, see Lockdown.
Malaysia and Singapore, became empty during the 	lockdowns	.
testing of Jordan residents during a localised 	lockdown	.
measures and supply shortages during the 	lockdown	
during the pandemic 	lockdown	 in South Africa.
non-pharmaceutical interventions, particularly 	lockdowns	 (encompassing
world's population was under some form of 	lockdown	, with more than
In addition to the health effects of 	lockdown	 restrictions,^[3]
researchers had found the 	lockdowns	 may have reduced crime and violence
terrorist groups.^[4] In addition, 	lockdowns	 had increased the uptake
concluded that 	lockdowns	 were somewhat effective at reducing the spread
strongest 	lockdowns	.^[21] Modelling on the United States pandemic
from significantly taking off if the 	lockdown	 measures were implemented
had the 	lockdown	 lasted another two weeks.^[16]
The stringent 	lockdown	 in Hubei in early 2020 proved effective at
	lockdowns	, is thought to be at least partly attributable to this
transmission through a strict 	lockdown	 lowers healthcare and economic
adopted in Australia, and a strict four-month 	lockdown	 in the state of
included targeted 	lockdowns	.^[31]^[32] A natural experiment study finds
that the partial 	lockdown	 in Kyrgyzstan (with curfews) was just as
effective as the full 	lockdown	 in Kazakhstan (with many business
2021 led some commentators to suggest that although 	lockdowns	 continue
outbreaks proved less effective at containment than previous 	lockdowns	
involuntary 	lockdowns	 had little impact, with voluntary distancing
transmission occurred during a strict national 	lockdown	, and that
	lockdowns	.^[54] This includes an Imperial College projection, led by
	lockdowns	 and computer modeling has verified that they have
A notable opponent of 	lockdowns	 has included Sweden's state
However, the Swedish government began considering enacting a 	lockdown	
While arguing in August 2020 for the need for further 	lockdowns	 in the
"smarter 	lockdowns	" that impose restrictions on areas with high levels
The 	lockdowns	 had multiple effects on people's everyday lives. Some of
and meta-analyses indicate that the COVID-19 	lockdowns	 were associated
that quarantine and 	lockdown	 measures were frequently associated with
'	lockdown	' at home with their abusers at the same time that services to
against women since the 	lockdown	 in March 2020.^[85]
the 	lockdown	 response when he discussed the lack of weight that public
health authorities had given to the potential downsides of the 	lockdown	
[250px-Open_Ohio_Rally_IMG_0910_Did the COVID 	lockdowns	 work? Hereâs what we know two years on
Research shows that 	lockdowns	 helped control cases in general â but
<span>Did the COVID 	lockdowns	 work? Hereâs what we kno__
<div><p>Research shows that 	lockdowns	 helped control
<p>Since the UK first entered 	lockdown	 on March 23 2020, lit
<p>Unfortunately, this isnât possible for 	lockdowns	. There__
<p>So, were 	lockdowns	 appropriate strategy, or should govern
<p>In evaluating the 2020 	lockdowns	, we need to remember tha
<p>In both cases the introduction of 	lockdown	 regulations (f
<p>The 2020 	lockdowns	 demonstrated that societies are willin
Empty central London Carnaby Street taken during COVID-19 	lockdown	
Empty central London Carnaby Street taken during COVID-19 	lockdown	
Since the UK first entered 	lockdown	 on March 23 2020, little in the
be it a new medicine, vaccine or 	lockdown	 measure, involves comparing
Unfortunately, this isnât possible for 	lockdowns	. There are no directly
	lockdowns	â effects.
	lockdown	 to other measures â or doing nothing at all. Such models are
analyse the impact of 	lockdowns	. While accepting that no method of
support 	lockdown	 measures being effective. They also point out that
So, were 	lockdowns	 appropriate strategy, or should governments in
In evaluating the 2020 	lockdowns	, we need to remember that the
that 	lockdowns	 successfully slowed COVIDâs spread in spring 2020,
strength of 	lockdown	 restrictions is measured using the COVID response
In both cases the introduction of 	lockdown	 regulations (first graph
its 	lockdown	 introduced well before the first death in the country. Its
its 	lockdown	 response until almost two weeks after its first death.
Although British people reduced their mobility before 	lockdown	 was
that delaying 	lockdown	 had such a large impact is further proof of its
The 2020 	lockdowns	 demonstrated that societies are willing and capable
But, full â and particularly repeated â 	lockdowns	 can be seen as a
failure of other, more gradual public health policies. A 	lockdown	like when we emerge from this 	lockdown	.
Flattening the spread of COVID-19 using 	lockdowns	 allows health systems[	lockdown	-icon-2@3x.png]	lockdown	____________ (BUTTON) (BUTTON) Search
	lockdown	
lockÂ·âdown ËlÃ¤k-ËdauÌn  How to pronounce 	lockdown	 (audio)
plural 	lockdowns	
For those of you unfamiliar with a school 	lockdown	, it basically means
	lockdown	 drills/procedures
Authorities placed the central Chinese city under 	lockdown	 on Jan. 23
The San Francisco Bay Area 	lockdown	 and national guidelines signal a
While most people are at home during 	lockdown	, essential workers are
Examples of 	lockdown	 in a Sentence
Or more recently, COVID 	lockdowns	, Hunter Bidenâs laptop or the
	lockdown	. â Jonathan Limehouse, USA Today, 31 Dec. 2025 Shortly after
the year began, the 5-year-anniversary of the COVID-19 	lockdowns	
	lockdowns	 and highlighted how quickly suspects can disappear. â
	lockdown	
The first known use of 	lockdown	 was in 1973
Rhymes for 	lockdown	
See All Rhymes for 	lockdown	
	lockdown	
https://www.merriam-webster.com/dictionary/	lockdown	. Accessed 4 Jan.
	lockdown	
lockÂ·âdown ËlÃ¤k-ËdauÌn  How to pronounce 	lockdown	 (audio)
	lockdown	
lockÂ·âdown ËlÃ¤k-ËdauÌn  How to pronounce 	lockdown	 (audio)
More from Merriam-Webster on 	lockdown	
Nglish: Translation of 	lockdown	 for Spanish SpeakersFollowing the 	lockdown	 in China in late January, and a proactive
Economic impact of 	lockdown	 measures
adopted strict 	lockdowns	, the economic impact of which has now become
strict 	lockdown	 measures, while Korea kept the economy open and
In both Europe and Asia, 	lockdowns	 and other restrictions have imposed
of this unprecedented 	lockdown	, the economies in Asia and Europe should* Current: Preventing a â	lockdown	 generationâ in Europe and Central
Preventing a â	lockdown	 generationâ in Europe and Central Asia
Preventing a â	lockdown	 generationâ in Europe and Central Asia
about 	lockdown	 restrictions, access and participation in education,China Covid: The politics driving the hellish 	lockdowns	
through the fence, amid new Covid-19 	lockdown	, in Shanghai, China, 10
Driven by Mr Xi's approval, China's 	lockdowns	 have been incessant,
Beijing is the only major city to have avoided a full 	lockdown	 so far.
phase of Covid control measures kicked off - comparing 	lockdowns	 across
describe 	lockdowns	. The measures had become so controversial and
a "	lockdown	" but reduced movement that somehow would not affect the
enter. But, residents were told, it's not a 	lockdown	.
feels like a series of endless 	lockdowns	.
shut down for a month. Then in March, a 	lockdown	 was announced in
Chengdu was among several cities where a 	lockdown	 caused food shortages
Shanxi faced a 	lockdown	 without a single case being reported: officials
	lockdowns	 and mass testing.
actually happening in towns and cities across China. Several 	lockdowns	
total 	lockdowns	 by drawing attention to them, while local officials
From April onwards, the 	lockdown	 tallies in Beijing's announcements
	lockdowns	 even if only a handful of cases were reported.
And, experts say, it's no coincidence that the 	lockdowns	 started to
China that have entered 	lockdown	 each week between 1 March and 12
October 2022. There has been a measurable increase in city 	lockdowns	
Prof Hurst expects the intermittent 	lockdowns	 to last at least until
Coronavirus 	lockdown	 measures* Remain in the secured area until the 	lockdown	 is lifted.the UK has a clear, well-practised 	lockdown	 procedure in place and has
put an effective 	lockdown	 procedure in place. From assessing your site
safe during a 	lockdown	 or invacuation situation.
* What is a school lockdown and why should you have a 	lockdown	
* What does Ofsted say about 	lockdown	 procedures?
* How to create a 	lockdown	 procedure
* Why a lockdown alert system should be part of your 	lockdown	
What is a school lockdown and why should you have a 	lockdown	 procedure?
A school lockdown, often referred to as a school security 	lockdown	 in
Situations when a 	lockdown	 may be used include:
You may have also heard of the term âinvacuationâ. A 	lockdown	 is
circumstances. While a 	lockdown	 is used when there is the risk of
Every school should have a 	lockdown	 and invacuation procedure in place
have a security 	lockdown	 procedure, while the Terrorism (Protection of
What does Ofsted say about 	lockdown	 procedures?
Ofstedâs guidance on 	lockdown	 procedures is vague, and many unions such
Ofsted states that every school should have a security 	lockdown	 plan,
Right now, Ofsted inspectors do not advocate for the need for 	lockdown	
go further and require a 	lockdown	 alarm system to be in place in order
alarms signal evacuation, whereas in a 	lockdown	 situation itâs crucial
inspection framework. Having a school 	lockdown	 procedure is a clear way
How to create a 	lockdown	 procedure
If your school doesnât yet have a formal 	lockdown	 plan in place, now is
creating a 	lockdown	 procedure.
finalise your 	lockdown	 procedure.
3. Write your 	lockdown	 procedure
Now you know where you can safely accommodate people during a 	lockdown	,
itâs time to write your 	lockdown	 procedure.
Time is of the essence in a 	lockdown	 situation. Just like in a fire,
respond. Thatâs why schools should consider using a dedicated 	lockdown	
At Little Green Button, we recommend a customisable 	lockdown	 alert that
Without clear leadership, 	lockdown	 situations can quickly become
charge when a 	lockdown	 is triggered. To ensure someone is always
have access to key tools such as the PA system, CCTV, and any 	lockdown	
One effective approach is to build your 	lockdown	 procedure on top of
equipped to support 	lockdown	 scenarios too.
Thereâs no specific legal requirement to conduct 	lockdown	 drills in
in your 	lockdown	 procedures as part of their induction.
Why a lockdown alert system should be part of your 	lockdown	 procedure
A clear, unmistakable way to alert staff to a 	lockdown	 situation is
pupils to evacuate. A 	lockdown	 alarm must do the opposite: instruct
advises against using fire alarms during 	lockdown	 events, as they can
Instead, schools should install a dedicated 	lockdown	 alert system that:
* Clearly distinguishes a 	lockdown	 from other types of emergency
Button provides a simple, effective 	lockdown	 alert system and panic
allowing staff to call for help or initiate a 	lockdown	 at the click of
to different groups, such as 	lockdowns	 to all staff, or medical
âWe have seen a significant increase in demand for 	lockdown	 and
	lockdown	 procedure and alert system in place is essential.
	lockdown	 planning?the different types of 	lockdowns	 commonly used in schoolsâsoft
lockdowns, hard lockdowns, and code red 	lockdowns	âalong with their
A soft lockdown is a precautionary 	lockdown	 used when there is no
During a soft 	lockdown	, access to the school is restricted, and
* Enables staff to quickly upgrade to a hard 	lockdown	 if the threat
While a soft lockdown is generally precautionary, a hard 	lockdown	 is
	lockdown	, teachers and students follow strict protocols to minimize
This level of 	lockdown	 is designed to protect the school community from
training to enhance 	lockdown	 procedures, empowering teachers and
A code red lockdown is the highest level of 	lockdown	, often associated
administrators is critical during a code red 	lockdown	 to ensure a
blue in school to designate different types of 	lockdowns	 or
face, necessitating specialized training. Traditional 	lockdowns	 are not
traditional 	lockdowns	, ALICE provides options to evacuate, barricade,Teacher monitoring students inside a classroom while school 	lockdown	
for robust safety measures. Among these, 	lockdown	 systems have emerged
as a critical component in safeguarding schools. Implementing 	lockdown	
A school 	lockdown	 system is a comprehensive security solution designed
hotkey), one-touch mobile app buttons, or traditional 	lockdown	 buttons.
	lockdowns	 help minimize risk by keeping people safely inside designated
to everyone except first responders, strobes are triggered, a 	lockdown	
A well-designed 	lockdown	 system provides schools with a critical layer
threats. Here are the key benefits of having a 	lockdown	 system in
The primary benefit of a 	lockdown	 system is the immediate protection it
Modern 	lockdown	 systems integrate with emergency notification
a 	lockdown	 is activated. This reduces response time and ensures
	lockdown	 responses based on the nature of the threat. For example, a
partial 	lockdown	 can be activated to secure specific wings or
classrooms, while a full 	lockdown	 ensures that all entry points are
Modern 	lockdown	 systems are designed to seamlessly integrate with
preparedness plans, including 	lockdown	 procedures. Implementing an
advanced 	lockdown	 system enhances compliance with safety standards and
	lockdowns	 and emergency preparedness. Ensuring proper safety measures
our 	lockdown	 solutions can keep your students safe!Stay prepared for emergency 	lockdown	 situations at school. Learn how to
	lockdown	.
or 	lockdown	. Practice emergency drills are becoming the norm in
However, in the unlikely event of a 	lockdown	 situation where students
or 	lockdown	.
have insulin always accessible, this may be difficult in a 	lockdown	
medication in the event of a rare 	lockdown	 or evacuation.
	lockdown	/emergency provision in your child's Section 504 Plan or
be incorporated in its 	lockdown	/emergency evacuations protocols andin their backyard. One difficult call is whether to 	lockdown	 the
hospital was on 	lockdown	 after receiving victims of the shooting at
hospital was on 	lockdown	 after receiving victims of the shooting at
the door. The facility was on 	lockdown	 after receiving several victims
hospital officials said the 	lockdown	 would be in place all night â
said enhanced security protocols like 	lockdowns	 are standard when
loved ones during a 	lockdown	.
about 	lockdowns	, said Butler, who has been in the health care security
"Sometimes, we stay in these elevated 	lockdown	 stages longer than we
Still, hospital security experts defend 	lockdowns	 as an important
As painful as 	lockdowns	 can be for family members, "our first and
The 	lockdown	 began at around 4 p.m. A few hours into it, tensions were
By the time the 	lockdown	 lifted at 9 p.m. on Feb. 14, Fawn Patterson
* 	lockdown	Strategies for 	lockdown	
COVID-19 Strategies for 	lockdown	
* Isolation and 	lockdown	
+ Strategies for 	lockdown	
Strategies for managing 	lockdown	
Coping with 	lockdown	 means adapting daily life to these new
Remember the reasons behind the 	lockdown	.
	lockdown	, you are advised to:
during 	lockdown	.
saying goodbye to family members during 	lockdown	.weeks, the Italian government imposed 	lockdowns	 for the entire country
	lockdown	/invacuation (inverse evacuation) procedures, as well as
	lockdown	.^[67]
shelter-in-place orders, shutdowns or 	lockdowns	.^[103]
	lockdown	,^[104] which increased to 2.6 billion people two days
Further information: COVID-19 	lockdown	 in Hubei
limit the rate of spread of the disease. The '	lockdown	' of Wuhan, and
subsequently a wider-scale '	lockdown	' throughout Hubei province, began
Further information: COVID-19 pandemic in Italy and COVID-19 	lockdown	
Eventually the 	lockdown	 was extended until 3 May, although starting
Regional 	lockdowns	 were subsequently imposed as further waves of the
began instituting policies of 	lockdown	. Notable among these were
	lockdown	 was announced on 14 March),^[122] Czech Republic, Norway,
As of 18 March 2020, more than 250 million people were in 	lockdown	
Korea had all imposed some degree of 	lockdown	 by 19 February.^[125] As
	lockdowns	.^[125] Africa and Latin America were relatively delayed in
to impose travel bans and lockdowns. Brazil and Mexico began 	lockdowns	
early March.^[125] Much of Africa was on 	lockdown	 by the start of
of the population, were under some form of 	lockdown	 in the United
States,^[127] 59 million people were in 	lockdown	 in South Africa,^[128]
and 1.3 billion people were in 	lockdown	 in India.^[129]^[130]
105. ^ "A third of the global population is on coronavirus 	lockdown	 â
111. ^ Coronavirus: Authorities order the 	lockdown	 of northern Italy to
116. ^ "Italy extends 	lockdown	 until May 3rd despite pressure from
119. ^ Anger as Italy slowly emerges from long Covid-19 	lockdown	 4 May
120. ^ "Coronavirus: Italy imposes regional 	lockdown	 as Europe battles
122. ^ Jones S (14 March 2020). "Spain orders nationwide 	lockdown	 to
125. ^ ^a ^b ^c ^d Coronavirus: The world in 	lockdown	 in maps and
home. This map shows which cities and states are under 	lockdown	".
129. ^ Nair S (29 March 2020). "For a billion Indians, 	lockdown	 has not
130. ^ "Chaos and hunger amid India coronavirus 	lockdown	". Al-Jazeera.Israeli forces take over homes, impose 	lockdown	 on West Bankâs Qabatiya
	lockdown	 and a complete cordonâ around Qabatiya.Israeli forces imposed a 	lockdown	 on a Palestinian village in the
the village of Qabatiya ... accompanied by a 	lockdown	 and a completeparamilitary forces, and Jammu and Kashmir Police. A temporary 	lockdown	
+ 2019â2021 	lockdown		lockdown	, doing either all or part of their lessons online. First thereParis 	lockdown	 leaves streets stuck in 1942 for abandoned film set
coronavirus 	lockdown	, leaving the streets with fake facades for corset
neighbourhood was being used as a film set when the 	lockdown	 hit. NowCoronavirus: Soldier uses war zone experience to get through 	lockdown	
	lockdown	.
He said: "You can't live in fear. In this 	lockdown	 people need to take
"This 	lockdown	 will not last forever so people need to pick something
find a hobby you like doing until the 	lockdown	 is lifted.
distancing rules under 	lockdown	
He said: "The 	lockdown	 is comparable to operations when we're in
"Being in 	lockdown	 therefore is not alien to the guys who have been on
"In this 	lockdown	 it is hard to see an end point because of the fog offorce to cope with the epidemic, including nationwide 	lockdown	. What is
As soon as the 16^th March, the nationwide 	lockdown	 was decided, and
	lockdown	 was decided by Governmental Decree 2020-260, signed by the
of a nationwide 	lockdown	, probably explains why the Decree also
restrictions, the content of the two previous 	lockdown	 Decrees
aggravating the existing 	lockdown	 measures and in particular âreviewCoronavirus: Half of humanity now on 	lockdown	 as 90 countries call for
coronavirus 	lockdown	, says a trade union.
advisable to wear masks, and whether stricter 	lockdowns	 should be	lockdowns	 were âunnecessaryâ Comments Feed oEmbed (JSON) oEmbed (XML)
Dominic Cummings: later 	lockdowns	 were âunnecessaryâ
Cummings labelled the first national 	lockdown	 âdefensibleâ. Credit:
Cummings labelled the first national 	lockdown	 âdefensibleâ. Credit:
Boris JohnsonCovid InquiryCOVID-19Dominic Cummings	lockdown	
All the later Covid 	lockdowns	 were âunnecessaryâ, Dominic Cummings has
there never needed to be any 	lockdown	 or anything approaching a
	lockdown	 in Quarter 3, Quarter 4 of 2020, or in 2021â. Had the
suggested, âthere would never have been any need for further 	lockdowns	
Downing Street when Britain first entered a national 	lockdown	 in March
[	lockdown	] was defensible in the sense of: there was no system, there
November, Cummings had warned Johnson in March 2020 that a 	lockdown	 was
impose 	lockdown	 that spring. For Cummings, âsome kind of short
no need for 	lockdowns	â later that year. While he stated that it was
need for the first 	lockdown	â had advisers and ministers engaged in
claimed that âall the later 	lockdowns	 were unnecessary and happenedthe public health emergency included travel restrictions, 	lockdowns	,
advisories to stringent 	lockdowns	. Outbreak control strategies are
contact tracing, mass testing, border quarantine, 	lockdowns	, and
	lockdowns	 and are widely considered the most strict. The New Zealand
so-called "circuit breaker 	lockdowns	" and financial support for those
most stringent 	lockdown	 measures. Subsequent data from China's health
Main articles: COVID-19 	lockdowns	, COVID-19 pandemic by country and
National reactions ranged from strict 	lockdowns	 to public education
campaigns.^[267] WHO recommended that curfews and 	lockdowns	 should be
people worldwide were under some form of 	lockdown	.^[269] This increased
	lockdowns	. A February 2021 study found that protests against
China opted for containment, instituting strict 	lockdowns	 to eliminate
a nationwide 	lockdown	 starting 24 March 2020,^[290] with a phased
Kolkata.^[291] Post-	lockdown	, the Government of India introduced a
worldwide to introduce a national 	lockdown	.^[318] By 13 March 2020, the
were in 	lockdown	 in Europe.^[322] Despite deployment of COVID-19
restrictions but no national 	lockdown	.^[337]^[338]^[339]^[340] By
longer-term measures, based on the assumption that after 	lockdown	 the
[250px-Open_Ohio_Rally_IMG_0910_pandemic (even if less than at the height of 	lockdowns	), with the
technology after being âforcedâ to during the 	lockdown	. Not all, but
HOPES: âThe 	lockdown	 has already helped many people realize what they
an existential threat while the rest of the world folded into 	lockdowns	The report looks at whether 	lockdowns	 were timely and reasonable, and
The report says 	lockdown	 could have been avoided if steps such as
	lockdown	 was inevitable, it says.
full stay-at home 	lockdown	 seven days later.
But 	lockdown	 a week earlier could have saved thousands of lives
Bringing in 	lockdown	 a week earlier on 16 March would have meant 23,000
have been reduced by an earlier 	lockdown	.
face of the looming pandemic and "oscillation" on key 	lockdown	
While the 	lockdowns	 of 2020 and 2021 undoubtedly saved lives, they also
March 2020; two visits to a second home during 	lockdown	 by the chief
he was in relationship during 	lockdown	.
national 	lockdown	, with Scotland, Wales and Northern Ireland adopting a
to learn lessons from the first 	lockdown	, and introduced tough,
	lockdown	.
Coronavirus 	lockdown	 measuresA 	lockdown	, or lockup, is a designated period when certain
A 	lockdown	, also known as a lockup, is a period of time in which
* A 	lockdown	 is a period of time in which holders of a companyâs
* The period following the expiration of the 	lockdown	 can be
Although 	lockdown	 periods are not required by law, they are frequently
Because underwriters often insist on a 	lockdown	 period, investors
	lockdown	 doesn't necessarily indicate they're confident in the future
The end of the 	lockdown	 can be turbulent for investors, because it's
A notable example of a 	lockdown	 period is that of Facebook (FB), which
Facebookâs IPO included a 180-day 	lockdown	 period which ended in
expiration of its 	lockdown	 period. The shares had gained nearly 10-fold
	lockdown	 period, new retail and institutional investors quickly took	lockdown	
The prison 	lockdown	 continues, more than three weeks after the death
implemented a statewide 	lockdown	 to slow the spread of the
The school remains under 	lockdown	 due to police activity in the
The governor implemented a statewide 	lockdown	 to slow the spread of
The army base was on 	lockdown	 after a report of shots fired.
Banks arenât lending during this credit 	lockdown	.
	lockdown	 British
many schools remained under 	lockdown	 yesterday
Origin of 	lockdown	
some of the strictest 	lockdowns	 in China, if not the world.
	lockdown	 saw Barry spend more time outside hunting for these
funeral in 2020 made headlines after claims it broke 	lockdown	
	lockdown	.â
It arrived when the Covid 	lockdown	 had just begun and attention wasA 	lockdown	 occurs when occupants of the University are directed to
	lockdown	 rests primarily with the University Police, both the
help ensure safe and efficient handling of University 	lockdown	 events.
Sheltering in place is similar to 	lockdown	 in that the occupants are to
A â	lockdown	â condition is initiated for weapons related violence,
* Be prepared for 	lockdown	 to last hours.
This 	lockdown	 plan remains fluid and may be changed during anthe lockdown than pre-	lockdown	 period.
	lockdown	.
critically important. In this context the country 	lockdown	 initiated to
during selected 	lockdown	 periods using satellite and in-situ datasets.
This analysis compares air quality levels during the 	lockdown	 against
pre-	lockdown	 conditions as well as against regional long-term mean.
9.5On April 8, 2020, the Chinese government lifted its 	lockdown	 of Wuhan.
using the word 	lockdown	 instead â and reacting with horror. âThat the
the Washington Post that âthese kinds of 	lockdowns	 are very rare and
million people had been forced into 	lockdowns	, China recorded its first
For the next two years, harsh 	lockdowns	 remained Chinaâs default
outside. And when the Chinese government finally abandoned 	lockdowns	 â
	lockdowns	 went from being regarded as something that only an
science.â But there was never any science behind 	lockdowns	 â not a
stopping a pandemic. When you got right down to it, 	lockdowns	 were
Despite the lack of scientific evidence, 	lockdowns	 didnât come out of
The men Bush chose to lead the effort believed that 	lockdowns	 could be
stopped short of mandating 	lockdowns	 but came as close as its authors
that were at least as relevant. Could the kinds of 	lockdowns	 that are
pandemic? Did the virus truly go away during a 	lockdown	 or simply hide,
	lockdowns	. While it is reasonable to think of that policy (in all its
clear about the fact that 	lockdowns	 for any purpose other than keeping
how the damage from 	lockdowns	 outweighed the benefits, it is at least
coronavirus. The Italian government responded with a 	lockdown	 almost as
Italians had died of COVID-19, up from 630 when the 	lockdown	 was first
	lockdowns	 were suddenly a real-world policy option in Western
governments to commit to 	lockdowns	 for the long haul. â[T]his type of
planned to keep the country open. Instead, he ordered a 	lockdown	 within
the 	lockdown	, Ferguson was visited twice by his mistress. For obvious
As for President Donald Trump, he never used the word 	lockdown	, but he
questions that no one advocating for 	lockdowns	 addressed, maybe because
long would they last? And even if 	lockdowns	 did slow the virusâs
Regardless, in the space of two months, 	lockdowns	 had gone from being
why 	lockdowns	 were necessary, they talked primarily about âbendingâ or
stateâs 	lockdown	 on March 19, âwe can truly bend the curve to reduce
announced a 	lockdown	 plan for New York. He called it his PAUSE program
what would happen without 	lockdowns	, they explained. Then they would
display a second chart showing a more gradual upturn once 	lockdowns	 and
crisis. Even those who later criticized 	lockdowns	 largely agreed on
envoy (and an eventual 	lockdown	 critic), put it, âThe only time we
believe a 	lockdown	 is justified is to buy you time to reorganize,
reimposed 	lockdowns	 whenever there was an uptick in COVID cases â not
Which naturally leads to the obvious question: Did 	lockdowns	 help keep
methodology, even their definition of 	lockdown	. For instance, in August
journal The Lancet, printed a study that concluded that âfull 	lockdowns	
in this paper suggest that more severe 	lockdown	 policies have not been
words,â he added, âthe 	lockdowns	 have not worked as intended.â
Minnesota, also doesnât think 	lockdowns	 did any good. âThere is
actually no role for 	lockdowns	,â he says. âLook at what happened in
curve, âthatâs not a real 	lockdown	,â Osterholm says. âYouâre just
Dr. Anthony Fauci was probably the best-known defender of 	lockdowns	 as
	lockdowns	 did not save many lives. By our count, there are at least 50
factors appear to have made a bigger difference than 	lockdowns	 (which
So in attempting to gauge the value of 	lockdowns	, the most appropriate
institute 	lockdowns	, it wound up seeing a lower overall death rate
available data that the 	lockdowns	 led to more overall deaths in the
There were other negative consequences too. In the U.S., 	lockdowns	
whose schools were closed as part of a 	lockdown	. During the first weeks
The anti-	lockdown	 scientist Jay Bhattacharya of Stanford University
	lockdown	 right then and there. It should have at least ended school
theyâre at work. One consequence of 	lockdowns	 was that millions of
began the pandemic believing in the importance of 	lockdowns	 and other
complete regression. It was devastating, and the downsides of 	lockdowns	
advocacy of 	lockdowns	, especially given its effect on children. At one
* 	lockdowns	On April 8, 2020, the Chinese government lifted its 	lockdown	 of Wuhan.
using the word 	lockdown	 instead â and reacting with horror. âThat the
the Washington Post that âthese kinds of 	lockdowns	 are very rare and
million people had been forced into 	lockdowns	, China recorded its first
For the next two years, harsh 	lockdowns	 remained Chinaâs default
outside. And when the Chinese government finally abandoned 	lockdowns	 â
	lockdowns	 went from being regarded as something that only an
science.â But there was never any science behind 	lockdowns	 â not a
stopping a pandemic. When you got right down to it, 	lockdowns	 were
Despite the lack of scientific evidence, 	lockdowns	 didnât come out of
The men Bush chose to lead the effort believed that 	lockdowns	 could be
stopped short of mandating 	lockdowns	 but came as close as its authors
that were at least as relevant. Could the kinds of 	lockdowns	 that are
pandemic? Did the virus truly go away during a 	lockdown	 or simply hide,
	lockdowns	. While it is reasonable to think of that policy (in all its
clear about the fact that 	lockdowns	 for any purpose other than keeping
how the damage from 	lockdowns	 outweighed the benefits, it is at least
coronavirus. The Italian government responded with a 	lockdown	 almost as
Italians had died of COVID-19, up from 630 when the 	lockdown	 was first
	lockdowns	 were suddenly a real-world policy option in Western
governments to commit to 	lockdowns	 for the long haul. â[T]his type of
planned to keep the country open. Instead, he ordered a 	lockdown	 within
the 	lockdown	, Ferguson was visited twice by his mistress. For obvious
As for President Donald Trump, he never used the word 	lockdown	, but he
questions that no one advocating for 	lockdowns	 addressed, maybe because
long would they last? And even if 	lockdowns	 did slow the virusâs
Regardless, in the space of two months, 	lockdowns	 had gone from being
why 	lockdowns	 were necessary, they talked primarily about âbendingâ or
stateâs 	lockdown	 on March 19, âwe can truly bend the curve to reduce
announced a 	lockdown	 plan for New York. He called it his PAUSE program
what would happen without 	lockdowns	, they explained. Then they would
display a second chart showing a more gradual upturn once 	lockdowns	 and
crisis. Even those who later criticized 	lockdowns	 largely agreed on
envoy (and an eventual 	lockdown	 critic), put it, âThe only time we
believe a 	lockdown	 is justified is to buy you time to reorganize,
reimposed 	lockdowns	 whenever there was an uptick in COVID cases â not
Which naturally leads to the obvious question: Did 	lockdowns	 help keep
methodology, even their definition of 	lockdown	. For instance, in August
journal The Lancet, printed a study that concluded that âfull 	lockdowns	
in this paper suggest that more severe 	lockdown	 policies have not been
words,â he added, âthe 	lockdowns	 have not worked as intended.â
Minnesota, also doesnât think 	lockdowns	 did any good. âThere is
actually no role for 	lockdowns	,â he says. âLook at what happened in
curve, âthatâs not a real 	lockdown	,â Osterholm says. âYouâre just
Dr. Anthony Fauci was probably the best-known defender of 	lockdowns	 as
	lockdowns	 did not save many lives. By our count, there are at least 50
factors appear to have made a bigger difference than 	lockdowns	 (which
So in attempting to gauge the value of 	lockdowns	, the most appropriate
institute 	lockdowns	, it wound up seeing a lower overall death rate
available data that the 	lockdowns	 led to more overall deaths in the
There were other negative consequences too. In the U.S., 	lockdowns	
whose schools were closed as part of a 	lockdown	. During the first weeks
The anti-	lockdown	 scientist Jay Bhattacharya of Stanford University
	lockdown	 right then and there. It should have at least ended school
theyâre at work. One consequence of 	lockdowns	 was that millions of
began the pandemic believing in the importance of 	lockdowns	 and other
complete regression. It was devastating, and the downsides of 	lockdowns	
advocacy of 	lockdowns	, especially given its effect on children. At one
* 	lockdowns	during 	lockdown	.
* Younger age groups have spent 	lockdown	 in considerably poorer
* One-in-five children from a low-income household has spent 	lockdown	
has widened over the 	lockdown	 period.
during the 	lockdown	 period. Moreover, the inequalities in living